0,0,0,0,0,0,0,0,0,0,0,0,0,0,0,0,0,0,0,0,0,0
0,0,0,0,0,0,0,0,0,0,0,0,0,0,0,0,0,0,0,0,0,0
0,0,0,0,0,0,0,0,0,0,0,0,0,0,0,0,0,0,0,0,0,0
0,0,0,0,0,0,0,0,0,0,0,0,0,0,0,0,0,0,0,0,0,0
0,0,0,0,0,0,0,0,0,0,0,0,0,0,0,0,0,0,0,0,0,0
0,0,0,0,2,2,2,2,2,2,2,2,2,2,2,2,2,2,0,0,0,0
0,0,0,0,2,13,13,13,2,13,13,13,13,13,13,13,13,2,0,0,0,0
0,0,0,0,2,13,1;3;6_10301,1,2,1,1,1,13,13,1,1;1_0,13,2,0,0,0,0
0,0,0,0,2,13,1,1,1,1,1,1,13,13,1,1,13,2,0,0,0,0
0,0,0,0,2,13,1,1,1,1,1,1,1,1,1,1,13,2,0,0,0,0
0,0,0,0,2,13,1,1,13,1,13,1;6_10300,13,13,1,1,13,2,0,0,0,0
0,0,0,0,2,13,1,1;11_Avery,13,1,13,1,2,13,1,1,13,2,0,0,0,0
0,0,0,0,2,13,1,1,13,1,13,1,2,13,13,13,13,2,0,0,0,0
0,0,0,0,2,2,2,2,2,2,2,6;0_3_31_23.5;4_0,2,2,2,2,2,2,0,0,0,0
0,0,0,0,0,0,0,0,0,0,0,0,0,0,0,0,0,0,0,0,0,0
0,0,0,0,0,0,0,0,0,0,0,0,0,0,0,0,0,0,0,0,0,0
