0,0,0,0,0,0,0,0,0,0,0,0,0,0,0,0,0,0,0,0,0,0,0,0,0,0,0,0,0,0,0,0,0,0,0
0,0,0,0,0,0,0,0,0,0,0,0,0,0,0,0,0,0,0,0,0,0,0,0,0,0,0,0,0,0,0,0,0,0,0
0,0,0,0,0,0,0,0,0,0,0,0,0,0,0,0,0,0,0,0,0,0,0,0,0,0,0,0,0,0,0,0,0,0,0
0,0,0,0,0,0,2,2,2,6;6_201;4_2,2,0,0,0,0,0,0,0,0,0,2,6;6_201;4_2,2,2,2,0,0,0,0,0,0,0,0,0,0
0,0,0,0,0,2,2,1,1,1;6_10700;2,2,0,0,0,0,0,0,0,0,0,2,1;6_10700,1,1,2,2,0,0,0,0,0,0,0,0,0
0,0,0,0,2,2,1,1,1,1,2,2,2,2,2,2,2,2,2,2,2,1,1,1,1,2,2,0,0,0,0,0,0,0,0
0,0,0,0,2,1,1,1,1,1,1,1,1,1,1,1,1;1_1,1,1,1,1,1,1,1,1,1,2,0,0,0,0,0,0,0,0
0,0,0,0,2,13,13,13,13,13,1;1_1,1;1_0,13,13,13,13,13,13,13,1;1_0,1;1_1,13,13,13,13,13,2,0,0,0,0,0,0,0,0
0,0,0,0,2,2,1,1;1_0,1,1,1,1,1,1,1,1;1_0,1,1,1,1,1,1,1;1_1,1,1;1_0,2,2,0,0,0,0,0,0,0,0
0,0,0,0,0,2,13,13,13,13,13,1,1,13,13,13,13,13,1,1,13,13,13,13,13,2,0,0,0,0,0,0,0,0,0
0,0,0,0,0,2,2,1,1,1;1_0,1,1,1;1_1,1,1,1;1_0,1,1;1_0,1,1,1,1,1;1_0,1,2,2,0,0,0,0,0,0,0,0,0
0,0,0,0,0,0,2,13,13,13,13,1,1,13,13,13,13,13,1,1,13,13,13,13,2,0,0,0,0,0,0,0,0,0,0
0,0,0,0,0,0,2,2,1,1,1;1_0,1,1;1_0,1,1,1,1;1_0,1;1_0,1;1_0,1;1_0,1;1_0,1,1,2,2,0,0,0,0,0,0,0,0,0,0
0,0,0,0,0,0,0,2,13,13,13,1;6_10701,1;6_10701,13,13,13,13,13,1;6_10701,1;6_10701,13,13,13,2,0,0,0,0,0,0,0,0,0,0,0
0,0,0,0,0,0,0,2,2,1,1,1,1,1,1,1,1,1,1,1,1,1,2,2,0,0,0,0,0,0,0,0,0,0,0
0,0,0,0,0,0,0,0,2,1,1,1,1,1,1,1,1,1,1,1,1,1,2,0,0,0,0,0,0,0,0,0,0,0,0
0,0,0,0,0,0,0,0,2,1,1,1,1,1,13,13,13,1,1,13,13,1,2,0,0,0,0,0,0,0,0,0,0,0,0
0,0,0,0,0,0,0,0,2,1,1,1,1,1,1,1,1,1,1,1;11_Schwarz,1,1,2,0,0,0,0,0,0,0,0,0,0,0,0
0,0,0,0,0,0,0,0,2,2,2,2,2,2,2,2,2,2,2,2,2,2,2,0,0,0,0,0,0,0,0,0,0,0,0
0,0,0,0,0,0,0,0,0,0,0,0,0,0,0,0,0,0,0,0,0,0,0,0,0,0,0,0,0,0,0,0,0,0,0
0,0,0,0,0,0,0,0,0,0,0,0,0,0,0,0,0,0,0,0,0,0,0,0,0,0,0,0,0,0,0,0,0,0,0
0,0,0,0,0,0,0,0,0,0,0,0,0,0,0,0,0,0,0,0,0,0,0,0,0,0,0,0,0,0,0,0,0,0,0
0,0,0,0,0,0,0,0,0,0,0,0,0,0,0,0,0,0,0,0,0,0,0,0,0,0,0,0,0,0,0,0,0,0,0
0,0,0,0,0,0,0,0,0,0,0,0,0,0,0,0,0,0,0,0,0,0,0,0,0,0,0,0,0,0,0,0,0,0,0
0,0,0,0,0,0,0,0,0,0,0,0,0,0,0,0,0,0,0,0,0,0,0,0,0,0,0,0,0,0,0,0,0,0,0
0,0,0,0,0,0,0,0,0,0,0,0,0,0,0,0,0,0,0,0,0,0,0,0,0,0,0,0,0,0,0,0,0,0,0
0,0,0,0,0,0,0,0,0,0,0,0,0,0,0,0,0,0,0,0,0,0,0,0,0,0,0,0,0,0,0,0,0,0,0
0,0,0,0,0,0,0,0,0,0,0,0,0,0,0,0,0,0,0,0,0,0,0,0,0,0,0,0,0,0,0,0,0,0,0
0,0,0,0,0,0,0,0,0,0,0,0,0,0,0,0,0,0,0,0,0,0,0,0,0,0,0,0,0,0,0,0,0,0,0
0,0,0,0,0,0,0,0,0,0,0,0,0,0,0,0,0,0,0,0,0,0,0,0,0,0,0,0,0,0,0,0,0,0,0
0,0,0,0,0,0,0,0,0,0,0,0,0,0,0,0,0,0,0,0,0,0,0,0,0,0,0,0,0,0,0,0,0,0,0
0,0,0,0,0,0,0,0,0,0,0,0,0,0,0,0,0,0,0,0,0,0,0,0,0,0,0,0,0,0,0,0,0,0,0
0,0,0,0,0,0,0,0,0,0,0,0,0,0,0,0,0,0,0,0,0,0,0,0,0,0,0,0,0,0,0,0,0,0,0
0,0,0,0,0,0,0,0,0,0,0,0,0,0,0,0,0,0,0,0,0,0,0,0,0,0,0,0,0,0,0,0,0,0,0
0,0,0,0,0,0,0,0,0,0,0,0,0,0,0,0,0,0,0,0,0,0,0,0,0,0,0,0,0,0,0,0,0,0,0
