0,0,0,0,0,0,0,0,0,0,0,0,2,2,2,2,2,2,2,2,2,2,0,0,0,0,0,0,0,0,0,0,0,0,0,0,0,0,0,0,0,0,0,0,0
0,0,0,0,0,0,0,0,0,0,0,0,2,1,1,1,1,1,1,1,1,2,0,0,2,2,2,2,2,2,2,2,2,2,2,2,2,2,0,0,0,0,0,0,0
0,0,0,0,0,0,0,0,0,0,0,0,2,1,1,1,1,1,1,1,1,2,0,0,2,1,1,1,1,1,1,1,1,1,1,1,1,2,0,0,0,0,0,0,0
0,0,0,0,0,0,0,0,0,0,0,0,2,1,1,1,1;1_0,1,1,1,1,2,0,0,2,1,1,1,1,1,1,1,1,1,1,1,1;1_0,2,0,0,0,0,0,0,0
0,0,0,0,0,0,0,0,2,2,2,2,2,1,1,1,1,1,1,1,1,2,2,2,2,1,1,1,1,1,1,1,2,2,2,2,2,2,0,0,0,0,0,0,0
2,2,2,2,2,2,2,2,2,1,1,1,1,1,1,1,1,1,1,1,1,1,1,1,2,1,1,1,1,1,1,1,2,0,0,0,0,0,0,0,0,0,0,0,0
2,1,1;2,1,1,1,1;3_0,1,1,1,1,1,1,1,1,1,1,1,1,1,1,1,1,1,1,1,1,1,1,1,1,1,2,0,0,0,0,0,0,0,0,0,0,0,0
2,1,1,1,1,1,1,1,1,1,1,1,1,1,1,1,1,1,1,1,1,1,1,1,1,1,2,2,2,2,2,2,2,2,2,2,2,2,0,0,0,0,0,0,0
2,1,1,2,2,2,2,2,2,2,2,1,1,1,1,10;4_1_3,4;0_2_12.75_7.75,4;0_2_20.25_7.75,10;4_1_3,1,1,1,1,1,1,1,1,1,1,1,1,1,1,1,1,1,1,2,0,0,0,0,0,0,0
2,1,1,2,0,0,2,1,1,1,2,1,1,1,5;0_4_16_6.75,0,4;0_2_12.75_7.75,4;0_2_20.25_7.75,0,5;0_4_17_6.75,1,1,1,1,1,1,1,1,1,1,1,1,1,1,1,1,1,2,0,0,0,0,0,0,0
2,1,1,2,0,0,2,1,1,2,1,1,1,10;4_0_2,0,0,0,0,0,0,10;4_0_2,1,1,1,1,2,2,2,2,2,2,2,2,2,2,1,1,2,0,0,0,0,0,0,0
2,1,1,2,0,0,2,1,2,1,1,1,1,10;4_0_1,10;4_3_2,0,0,0,0,10;4_2_1,10;4_3_0,1,1,1,1,2,0,0,0,0,0,0,0,0,2,1;1_0,1,2,0,0,0,0,0,0,0
2,1,1;1_0,2,0,0,2,1,1,1,1,1,1,1,10;4_0_2,0,0,0,0,10;4_0_2,1,1,1,1,1,2,0,0,0,0,0,0,0,0,2,1,1,2,0,0,0,0,0,0,0
2,1,1,2,0,0,2,2,2,1,1,1,1,1,10;4_0_2,0,0,0,0,10;4_0_2,1,1,1,1,1,2,0,0,0,0,0,0,0,0,2,1,1,2,0,0,0,0,0,0,0
2,1,1,2,0,0,0,0,2,1,1,1,1,1,10;4_0_2,0,0,0,0,10;4_0_2,1,1,1,1,1,2,0,0,0,0,0,0,0,0,2,1,1,2,0,0,0,0,0,0,0
2,1,1,2,0,0,0,0,2,1,1,1,1,1,10;4_0_2,0,0,0,0,10;4_0_2,1,1,1,1,1,2,0,0,0,0,0,0,0,0,2,1,1,2,0,0,0,0,0,0,0
2,1,1,2,0,0,0,0,2,1,1,1,1,1,10;4_0_2,0,0,0,0,10;4_0_2,1,1,1,1,1,2,0,0,0,0,0,0,0,0,2,1,1,2,0,0,0,0,0,0,0
2,1,1,2,0,0,0,0,2,1,1,1,1,1,10;4_0_2,0,0,0,0,10;4_0_2,1,1;1_0,1,1,1,2,0,0,0,0,0,0,0,0,2,1,1,2,0,0,0,0,0,0,0
2,1,1,2,0,0,0,0,2,1,1,1;1_0,1,1,10;4_0_2,0,0,0,0,10;4_0_2,1,1,1,1;1_0,1,2,0,0,0,0,0,0,0,0,2,1,1,2,0,0,0,0,0,0,0
2,1,1,2,0,0,0,0,2,1,1;1_0,1,1;1_0,1,10;4_0_1,10;4_3_1,10;4_3_1,10;4_3_1,10;4_3_1,10;4_3_0,1;1_0,1,1,1,1,2,0,0,0,0,0,0,0,0,2,1,1,2,0,0,0,0,0,0,0
2,1,1,2,0,0,0,0,2,1,1,1,1,1,1,1,1,1,1,1,1,1,1,1,1;1_0,2,0,0,0,0,0,0,0,0,2,1,1;1_0,2,0,0,0,0,0,0,0
2,1,1,2,0,0,0,0,2,1,1,1,1,1,1,1,1,1,1,1,1,1,1,1,1,2,0,0,0,0,0,0,0,0,2,1,1,2,0,0,0,0,0,0,0
2,1,1,2,2,2,2,2,2,1,1,1,1,1,1,1,1,1,1,1,1,1,1,1,1,2,2,2,2,2,2,6;0_SysLab_6_6.5,2,2,2,1,1;1_0,2,0,0,0,0,0,0,0
2,1,1,1,1;1_0,1,1,1,1,1,1,2,2,2,2,2,2,2,2,2,2,2,2,1,1,1,1,1,1,1,1,1,1,1,1,1,1,2,0,0,0,0,0,0,0
2,1,1,1,1,1,1,1,1,1,1,2,0,0,0,0,0,0,0,0,0,0,2,1,1,1,1,1,1,1,1,1,1,1,1,1,1,2,0,0,0,0,0,0,0
2,2,2,2,2,2,2,2,2,1,1,2,0,0,0,0,0,0,0,0,0,0,2,1,1;1_0,2,2,2,2,2,2,2,2,2,2,2,2,2,0,0,0,0,0,0,0
0,0,0,0,0,0,0,0,2,1,1,2,2,2,2,2,2,2,2,2,2,2,2,1;1_0,1,2,0,0,0,0,0,0,0,0,0,0,0,0,0,0,0,0,0,0,0
0,0,0,0,0,0,0,0,2,1,1,1,1,1;1_0,1,1,1,1,1,1,1,1,1,1,1,2,0,0,0,0,0,0,0,0,0,0,0,0,0,0,0,0,0,0,0
0,0,0,0,0,0,0,0,2,1,1,1,1,1,1,1,1,1,1,1,1,1,1,1,1,2,0,0,0,0,0,0,0,0,0,0,0,0,0,0,0,0,0,0,0
0,0,0,0,0,0,0,0,2,2,2,2,2,2,2,2,2,2,2,2,2,2,2,2,2,2,0,0,0,0,0,0,0,0,0,0,0,0,0,0,0,0,0,0,0
0,0,0,0,0,0,0,0,0,0,0,0,0,0,0,0,0,0,0,0,0,0,0,0,0,0,0,0,0,0,0,0,0,0,0,0,0,0,0,0,0,0,0,0,0
0,0,0,0,0,0,0,0,0,0,0,0,0,0,0,0,0,0,0,0,0,0,0,0,0,0,0,0,0,0,0,0,0,0,0,0,0,0,0,0,0,0,0,0,0
0,0,0,0,0,0,0,0,0,0,0,0,0,0,0,0,0,0,0,0,0,0,0,0,0,0,0,0,0,0,0,0,0,0,0,0,0,0,0,0,0,0,0,0,0
0,0,0,0,0,0,0,0,0,0,0,0,0,0,0,0,0,0,0,0,0,0,0,0,0,0,0,0,0,0,0,0,0,0,0,0,0,0,0,0,0,0,0,0,0
0,0,0,0,0,0,0,0,0,0,0,0,0,0,0,0,0,0,0,0,0,0,0,0,0,0,0,0,0,0,0,0,0,0,0,0,0,0,0,0,0,0,0,0,0
0,0,0,0,0,0,0,0,0,0,0,0,0,0,0,0,0,0,0,0,0,0,0,0,0,0,0,0,0,0,0,0,0,0,0,0,0,0,0,0,0,0,0,0,0
0,0,0,0,0,0,0,0,0,0,0,0,0,0,0,0,0,0,0,0,0,0,0,0,0,0,0,0,0,0,0,0,0,0,0,0,0,0,0,0,0,0,0,0,0
0,0,0,0,0,0,0,0,0,0,0,0,0,0,0,0,0,0,0,0,0,0,0,0,0,0,0,0,0,0,0,0,0,0,0,0,0,0,0,0,0,0,0,0,0
0,0,0,0,0,0,0,0,0,0,0,0,0,0,0,0,0,0,0,0,0,0,0,0,0,0,0,0,0,0,0,0,0,0,0,0,0,0,0,0,0,0,0,0,0
0,0,0,0,0,0,0,0,0,0,0,0,0,0,0,0,0,0,0,0,0,0,0,0,0,0,0,0,0,0,0,0,0,0,0,0,0,0,0,0,0,0,0,0,0
0,0,0,0,0,0,0,0,0,0,0,0,0,0,0,0,0,0,0,0,0,0,0,0,0,0,0,0,0,0,0,0,0,0,0,0,0,0,0,0,0,0,0,0,0
0,0,0,0,0,0,0,0,0,0,0,0,0,0,0,0,0,0,0,0,0,0,0,0,0,0,0,0,0,0,0,0,0,0,0,0,0,0,0,0,0,0,0,0,0
0,0,0,0,0,0,0,0,0,0,0,0,0,0,0,0,0,0,0,0,0,0,0,0,0,0,0,0,0,0,0,0,0,0,0,0,0,0,0,0,0,0,0,0,0
0,0,0,0,0,0,0,0,0,0,0,0,0,0,0,0,0,0,0,0,0,0,0,0,0,0,0,0,0,0,0,0,0,0,0,0,0,0,0,0,0,0,0,0,0
0,0,0,0,0,0,0,0,0,0,0,0,0,0,0,0,0,0,0,0,0,0,0,0,0,0,0,0,0,0,0,0,0,0,0,0,0,0,0,0,0,0,0,0,0
