2,2,2,2,2,2,2,2,2,2
2,1;3_0,1,2,11,11,11,12,1,2
2,1,1,2,1,1,1,12,1,2
2,1,1,1,1,1,1,12,1,2
2,1,1,1,1,1,1,1,1,2
2,1,1,12,1,12,1,12,1,2
2,1,1,12,1,12,1,12,1,2
2,1,1,12,1,12,1,12,1,2
2,2,2,2,2,2,6;0_3_31_23.5,2,2,2
0,0,0,0,0,0,0,0,0,0
